R 1500 900

NO ./textures/shluz.xpm
SO ./textures/doom.xpm
WE ./textures/cement.xpm
EA ./textures/cherwall.xpm

S ./textures/monst.xpm
F 30,30,30
C 80,0,0

111111111111111111111111111111111111 
1E0000020001000100011000001000100011 
121222100100010001010011100010001001 
110022200101111101001010001111101111 
100101110111000102201000000000000001 
101101000100000000001010111111111111 
111001010001010000022010000100000001 
110001111111112002200110010110111101 
110011000000112010100100100000000001 
111001011110110101101001111111111101 
101101010000010100000010000101000001 
100101010111110101111110101001010111 
110100010100010110000010100000000001 
100101110001010000111011101111110101 
101100011100011010101000001000010001 
100001000001000012222211011011000121 
111111111111111111111111111111111111 