R 1280 720

NO ./textures/shluz.xpm
SO ./textures/doom.xpm
WE ./textures/cement.xpm
EA ./textures/cherwall.xpm

S ./textures/monst.xpm

F 30,30,30
C 80,0,0

11111111111111111
10022222022222221
10122222022222121
12212222022221221
12222222022222221
12222222022222221
12222222022222221
12222222022222221
10000000000000001
12222222022222221
12222222022222221
12222222022222111
12222222022222001
12212222022211101
12122222022211101
122222220220000N1
11111111111111111
