R 1920 1080

NO ./textures/shluz.xpm
SO ./textures/doom.xpm
WE ./textures/cement.xpm
EA ./textures/cherwall.xpm

S ./textures/monst.xpm
F 30,30,30
C 80,0,0

111111111111111111111111111111111
100000001000000000110000000000001
100000001011000001110000002000001
100000001001000000000000000000001
111111111011000001110000000000001
100000000011000001110111110111111
111101111111110111000000100011111
111101111111110111010100100011111
110000001101010111000000100011111
100020000000000011000000100011111
100000000000000011010100100011111
11000001110101011111011110N011111
111101110111010101011110100011111
111111111111111111111111111111111
